0001111111111111
0000000000000000
0000000000000000
0000000000000000
0000000000000000
0000000000000000
0000222222220000
0022222222222200
2222222222222222
2222222222222222
2222222222222222
2222222222222222
